4112111111111
1141111211111
1111214111111
4112111112111
1211121111411
1111112422111
1241121211121
1412211122111
1212214212111
1211221122114
4111112112111
1111112211411
1142111121121
1211121221142
2211111242111
1141211211111
1411112122121
1211122222141
2211241122121
1222211242111
2112412112112
1112212111242
1122212121214
1212222121114
1112211221214
4212122112111
1141121121221
1412221211212
1411112122212
2212221121114
1242112112111
1112122122421
1111124222121
1211111122224
2122211122114
1212211122214
1112122112421
2211211121124
4121222121121
1122122112421
